11111111111111111111111111111
10000000000000000000000001001
10P001000000001111100000000E1
1000010001000000C010000001111
10000111111100111110000000001
10000000010000100000000000001
1000000C010000111110000000001
10000000000000000000000000001
11111111111111111111111111111
